R 800 600            
NO ./texture/north.xpm
SO ./texture/south.xpm
WE ./texture/west.xpm          
EA ./texture/east.xpm                         
S ./texture/sprite.xpm 

F  139,134,130
C  72,209,204                 

        1111111111111111111111111
        1000000000110000000000001
        1011000001110000002000001
        1001000000000000000000001
111111111011000001110000000000001
100000000011000001110111111111111
11110111111111011100000010001
11110111111111011101010010001
11000000110101011100000010001
100020000S0000001100000010001
10002000000000001101010010001
1100000111010101111101111000111
11110111 1110101 101121010001
11111111 1111111 111111111111